e	、
i	。
q	い
w	ん
r	う
t	し
y	の
u	か
o	た
p	き
a	く
s	な
d	と
f	ょ
g	こ
h	り
j	っ
k	に
l	じ
;	ー
z	ま
x	つ
c	ら
b	さ
m	は
,	る
.	お
/	ち
eq	あ
ew	す
er	れ
et	が
ey	て
eu	せ
ei	み
eo	も
ep	け
ea	ゅ
es	め
ef	で
eg	だ
eh	ど
ej	ば
ek	わ
el	え
e;	ゃ
iq	や
iw	ろ
ie	ひ
ir	そ
it	ふ
iy	ぎ
iu	ぶ
io	よ
ip	を
ia	び
is	む
id	ほ
if	ね
ig	ご
ih	げ
ij	ぼ
il	ぐ
i;	ざ
vq	ゆ
vw	ず
ve	ぱ
vr	ぷ
vt	べ
vy	ぜ
vu	ぴ
vi	ぽ
vo	ぞ
vp	へ
nq	ぬ
nw	ぃ
ne	ぺ
nr	づ
nt	ぇ
ny	ぢ
nu	ゔ
ni	ぁ
no	ぅ
np	ぉ
