e	、
i	。
q	い
w	ん
r	う
t	し
y	の
u	か
o	た
p	き
a	く
s	な
d	と
f	ょ
g	こ
h	り
j	っ
k	に
l	じ
;	ま
z	つ
x	ら
c	さ
b	は
m	る
,	お
.	ち
/	あ
eq	す
ew	れ
er	が
et	て
ey	せ
eu	み
ei	も
eo	け
ep	ゅ
ea	め
es	で
ef	だ
eg	ど
eh	ば
ej	わ
ek	え
el	ゃ
e;	や
iq	ろ
iw	ひ
ie	そ
ir	ふ
it	ぎ
iy	ぶ
iu	よ
io	を
ip	び
ia	む
is	ほ
id	ね
if	ご
ig	げ
ih	ぼ
ij	ぐ
il	ざ
i;	ゆ
vq	ず
vw	ぱ
ve	ぷ
vr	べ
vt	ぜ
vy	ぴ
vu	ぽ
vi	ぞ
vo	へ
vp	ぬ
nq	ぃ
nw	ぺ
ne	づ
nr	ぇ
nt	ぢ
ny	ゔ
nu	ぁ
ni	ぅ
no	ぉ
np	ー
